XXXXXXXXXXXXXXXXXXXXXXXXXXXXXXXXXXXXXXXXXXXXXXXXXXXXXXXXXXXX
XXXXXXXXXXXXXXXXXXXXXXXXXXXXXXXXXXXXXXXXXXXXXXXXXXXXXXXXXXXX
XXXXXXXXXXXXXXXXXXXXXXXXXXXXXXXXXXXXXXXXXXXXXXXXXXXXXXXXXXXX
XXXXXXXXXXXXXXXXXXXXXXXXXXXXXXXXXXXXXXXXXXXXXXXXXXXXXXXXXXXX
XXXXXXXXXXXXXXXXXXXXXXXXXXXXXXXXXXXXXXXXXXXXXXXXXXXXXXXXXXXX
XXXXXXXXXXXXXXXXXXXXXXXXXXXXXXXXXXXXXXXXXXXXXXXXXXXXXXXXXXXX
XXXXXXXXXXXXXXXXXXXXXXXXXXXXXXXXXXXXXXXXXXXXXXXXXXXXXXXXXXXX
XXXXXXXXXXXXXXXXXXXXXXXXXXXXXXXXXXXXXXXXXXXXXXXXXXXXXXXXXXXX
XXXXXXXXXXXXXXXXXXXXXXXXXXXXXXXXXXXXXXXXXXXXXXXXXXXXXXXXXXXX
XXXXXXXXXXXXXXXXXXXXXXXXXXXXXXXXXXXXXXXXXXXXXXXXXXXXXXXXXXXX
XXXXXXXXXXXXXXXXXXXXXXXXXXXXXXXXXXXXXXXXXXXXXXXXXXXXXXXXXXXX
XXXXXXXXXXXXXXXXXXXXXXXXXXXXXXXXXXXXXXXXXXXXXXXXXXXXXXXXXXXX
XXXXXXXXXXXXXXXXXXXXXX2ddddddddd3XXXXXXXXXXXXXXXXXXXXXXXXXXX
XXXXXXXXXXXXXXXXXXX2dde---------sddddd3XXXXXXXXXXXXXXXXXXXXX
XXXXXXXXXXXXXX2dddde------------------lXXXXXXXXXXXXXXXXXXXXX
XXXXXXXXXXXXXXr-----------------------sdddd3XXXXXXXXXXXXXXXX
XXXXXXXXXXXXXX1n---------------------------lXXXXXXXXXXXXXXXX
XXXXXXXXXXXXXXXr---------------------------lXXXXXXXXXXXXXXXX
XXXXXXXXXXXXXXXr---------pppppp------------sd3XXXXXXXXXXXXXX
XXXXXXXXXXXXXXXr---------pppppp--------------lXXXXXXXXXXXXXX
XXXXXXXXXXXXXXXr--------------------pppp-----lXXXXXXXXXXXXXX
XXXXXXXXXXXXXX2e-----------------------------lXXXXXXXXXXXXXX
XXXXXXXXXXXXXXr------------------------------lXXXXXXXXXXXXXX
XXXXXXXXXXXXXXrfffffffffffffffffffffffffffffflXXXXXXXXXXXXXX
XXXXXXXXXXXXXXrgggggggggggggggggggggggggggggglXXXXXXXXXXXXXX
XXXXXXXXXXXXXXrgggggggggggggggggggggggggggggglXXXXXXXXXXXXXX
XXXXXXXXXXXXXXrgggggggggggggggggggggggggggggglXXXXXXXXXXXXXX
XXXXXXXXXXXXXXrgggggggggggggggggggggggggggggglXXXXXXXXXXXXXX
XXXXXXXXXXXXXXrgggggggggggggggggggggggggggggglXXXXXXXXXXXXXX
XXXXXXXXXXXXXXrgggggggggggggggggggggggggggggglXXXXXXXXXXXXXX
XXXXXXXXXXXXXXrgggggggggggggggggggggggggggggglXXXXXXXXXXXXXX
XXXXXXXXXXXXXXrgggggggggggggggggggggggggggggglXXXXXXXXXXXXXX
XXXXXXXXXXXXXXrgggggggggggggggggggggggggggggglXXXXXXXXXXXXXX
XXXXXXXXXXXXXXXXXXXXXXXXXXXXXXXXXXXXXXXXXXXXXXXXXXXXXXXXXXXX
XXXXXXXXXXXXXXXXXXXXXXXXXXXXXXXXXXXXXXXXXXXXXXXXXXXXXXXXXXXX
XXXXXXXXXXXXXXXXXXXXXXXXXXXXXXXXXXXXXXXXXXXXXXXXXXXXXXXXXXXX
XXXXXXXXXXXXXXXXXXXXXXXXXXXXXXXXXXXXXXXXXXXXXXXXXXXXXXXXXXXX
XXXXXXXXXXXXXXXXXXXXXXXXXXXXXXXXXXXXXXXXXXXXXXXXXXXXXXXXXXXX
XXXXXXXXXXXXXXXXXXXXXXXXXXXXXXXXXXXXXXXXXXXXXXXXXXXXXXXXXXXX
XXXXXXXXXXXXXXXXXXXXXXXXXXXXXXXXXXXXXXXXXXXXXXXXXXXXXXXXXXXX
XXXXXXXXXXXXXXXXXXXXXXXXXXXXXXXXXXXXXXXXXXXXXXXXXXXXXXXXXXXX
XXXXXXXXXXXXXXXXXXXXXXXXXXXXXXXXXXXXXXXXXXXXXXXXXXXXXXXXXXXX